***********
* *   *   *
* * * * * *
* *** * * *
*   * * * *
**      * *
***********