************************************************************
*             *                       *               *    *
**** **** *** * ** *** ****** *** *** * ************* * ** *
*               ** *        *                           ** *
*  * * * * *  * ** *        * *** **** ******************* *
*  * * * * *  * **   **  ** * *** **** ******************* *
*  * * * * *  * ** * **  ** * **                           *
*  * * * * *  * ** *   **     ** ******** ********* ****** *
*                  *  ****  * **                           *
**** ***** ******* *  ****  * ** * ******** ******** ***** *
*                * *  *  *  *    *          *           *  *
*  * **** ****** *          * **** *** **** * * * * * * * **
*  *           * * **********               * * * * * * * **
* ***** ****** *              **** *** **** *             **
* *          * * ******** * * *             ****** ****** **
* * ******** * *          *     ** *** **** *        **** **
* * ******** * * **** *** * * ***           * * ****      **
* *        *                *     *** *** *** * **** **** **
*   *      * * ****** * * * * * * *                        *
* * ******** * *      * * * *       ******* * * * ** * * * *
* * ******** *   ******   *   * * * *       * * *          *
* * ******** * * ****** * * *     * * ***** * * **** ***** *
*              *        *   *****   *         *      *     *
************************************************************